#,#,#,#,#,#,#,#,#,#,#,#,#,#,#,#,#,#,#,#,#,#
#,_,_,_,_,_,#,#,#,#,_,_,_,#,#,#,_,_,#,_,_,#
#,#,#,_,_,_,_,A,B,C,_,_,#,_,_,#,_,_,_,_,#,#
#,_,_,_,_,#,#,D,E,F,G,_,_,#,_,_,#,#,#,#,_,#
#,_,_,_,_,_,_,_,_,_,_,_,_,_,_,_,_,_,_,_,_,#
#,_,_,_,_,#,#,#,_,_,_,#,#,_,#,#,_,_,#,#,#,#
#,#,#,#,#,#,#,#,#,#,#,#,#,#,#,#,#,#,#,#,#,#
